8,0,0,0,3,2,4,9,1,0,0,0,0,0,0,3,0,0,0,0,1,0,0,7,6,0,2,0,0,0,0,0,0,0,0,0,0,4,0,0,0,0,8,5,0,7,0,6,8,0,0,0,0,0,0,0,0,0,6,0,0,4,0,6,7,0,0,0,8,0,0,0,0,0,3,9,2,1,7,0,8
6,0,0,0,2,0,0,0,4,0,1,0,4,0,0,0,0,9,0,9,3,0,0,0,7,1,0,9,0,0,0,7,3,0,0,0,0,5,2,0,0,6,0,0,0,0,0,1,2,0,0,8,5,3,0,0,0,3,1,0,0,2,8,0,3,4,0,6,2,0,9,0,0,2,0,8,4,0,0,7,0
0,0,2,0,0,0,5,4,0,0,0,0,2,0,4,0,0,3,0,7,1,0,0,3,0,0,8,0,0,0,0,6,1,9,0,0,0,0,0,4,5,0,0,6,0,2,0,0,8,0,0,0,3,0,0,0,0,0,0,6,0,5,1,0,0,4,0,0,0,0,0,0,3,0,0,0,0,0,0,0,0
0,0,7,0,3,0,0,4,0,0,2,0,0,4,6,0,8,0,4,0,8,0,0,0,3,0,0,0,1,0,0,0,0,8,0,0,0,0,9,5,2,0,0,7,0,0,0,0,0,1,7,0,9,6,0,0,0,0,0,0,0,0,9,5,0,1,2,0,0,0,3,7,0,0,0,9,0,0,4,5,0
0,0,0,0,0,0,0,0,0,0,0,0,0,0,4,0,5,8,0,0,8,6,7,0,0,0,0,3,2,0,0,8,0,1,9,4,0,7,0,1,0,0,2,0,6,0,0,0,0,0,0,0,0,3,6,0,0,0,0,0,0,4,0,2,1,9,3,0,0,8,0,7,0,8,0,0,6,7,0,0,0
0,0,0,3,0,4,0,1,0,0,0,0,7,0,0,0,0,0,8,3,9,0,1,0,0,6,0,0,1,0,4,0,8,0,7,0,0,0,0,0,0,0,0,0,1,6,0,3,9,0,0,0,0,4,0,0,0,0,0,0,0,9,5,0,2,8,0,0,3,0,0,0,9,0,6,5,0,0,0,0,0
0,0,2,8,0,0,0,3,0,0,0,0,4,0,5,0,6,0,0,0,0,0,1,6,9,0,0,0,0,3,0,0,0,0,0,0,0,4,0,0,0,0,0,0,0,0,0,0,0,6,0,0,5,1,7,1,0,0,3,0,0,0,8,0,0,0,2,4,0,0,0,3,0,2,0,0,0,0,5,4,0
0,0,0,0,0,0,0,6,9,0,0,0,0,0,0,0,0,0,1,0,0,8,0,4,0,0,0,0,6,0,0,0,0,0,0,0,0,7,0,0,0,5,0,0,4,0,0,0,2,4,3,0,8,0,0,0,1,0,9,0,3,2,0,2,0,0,6,1,0,0,5,0,0,0,0,3,0,0,0,7,0
0,0,0,1,0,3,0,0,0,1,0,6,0,0,0,0,5,0,0,0,0,0,0,0,9,6,0,2,9,3,0,0,0,7,0,0,0,0,0,3,0,0,0,0,2,8,7,0,5,0,0,0,0,4,0,0,0,0,0,2,0,8,6,0,5,0,8,0,0,0,0,0,9,0,0,4,1,5,0,2,0
